111111111111111111111111111111111
100000000000000000000000000000001
100011100000000000100000000000001
100000100000000000001001110000001
100000000000110000000001110000001
100001000000110001100000000000001
100010000000000001100000000000001
100001000000000000000000010000001
100010000010000000000000110000001
100000000010000000001000000000001
100000001110000110001100000000001
100000000000000000000000000000001
100011000000000000000111000000001
100000100000000000000111000000001
100000010001111111000111000000001
100000001000000000000111000000001
100000010000000000000000000000001
100010000000000000000000000000001
100010000001000110000000000001001
100000000001100010000000000001001
111111111111111111111111111111111
111111111111111111111111111111111
111111111111111111111111111111111